11111111111111111111111111111111111111111111111
1                           1                11
1                    1      1                11
11111                1      1      1111111   11
1       11111111111111      1            1   11
1                    1      1      1     1   11
1                    1             11   11   11
1    111 111   111111111111        1     1   11
1                         1        1         11
1              1                             11
1       111    111111111111           11  11 11
1        1                1111111     11  11 11
1        1                1                  11
1        1            11111       11  11  11 11
1   111111                        11  11  11 11
1                         1                  11
11111111111111111111111111111111111111111111111
11111111111111111111111111111111111111111111111