111111111111111111111111111
1           1    |        1
1           1    |        1
1           /    1WW1     1
1           1             1
1           1    1WW1     1
11---1=1---11    |        1
w                |        1
w                1  1--1  1
w                1  |  |  1
11WWWW1WWWW1WWWW11  |  |  1
1                1  1=11  1
1                w        1
1                w        1
1       1-1      w        1
1       | |      w        1
1     1-1 1-1    1        1
1           |             1
1     1-1 1-1    1        1
1       | |      w        1
1       1-1      w        1
1                w        1
1                w        1
1                1        1
11WWWW1WWWW1WWWW111111 1111
1                   2   2 1
1                   22222 1
1                   22222 1
1                   1   1 1
1                   1   1 1
1                   1   1 1
1                   1   1 1
1                   1   1 1
1                   1   1 1
1                   1   1 1
1                   1   1 1
1                   1   1 1
1                   1   1 1
1                   1   1 1
1                   1   1 1
