1111111111111111111111111111111111111111111111
1000000000000000010000100000000000000000000001
1000000000000000010000100000000000000000000001
1000000000000000010000100011100000000000000001
1000000000000000000000000010000000000000000001
1000000000000000000000000010000000000000000001
1000100000000000000000111110000000000000000001
1000100000000000000000000000000000000100000001
1000100000000000000000000000000000000100000001
1000100000000000000000000000000000000100000001
1000100000000000000000000000000000000100000001
1000100000000000000000100000000000000100000001
1000111111100011111111111100000111111111111111
1000000000000000000000111100000000000000000001
1000000000000000000000111100000000000000000001
1000000000000000000000100000000000000000000001
1000000000000000000000100000000000000000000001
1111111111111111111111111111111111111111111111