1121211111111111111111111111111111111111111111
1                           1                1
1                    1      1                1
11111                1      1      1111111   1
1       12221111111111      1            1   1
1                    1      1      1     1   1
1                    1             11   11   1
1    111 111   111111111111        1     1   1
1      1                  1        1         1
1      1       1                             1
1        11    111111111111           11  11 1
1        1                1111111     11  11 1
1        1                1                  1
1        1            11111       11  11  11 1
1   111111                        11  11  11 1
1                         1                  1
1111111111111111111111111111111111111111111111
